10 10
.xxxxxxxx.
x.x.x.x.x.
.x.x.x.x..
xxxxxxx...
..........
..........
..........
....xxx...
..........
..........