.............................................xx.........................xx..xx..............xx.xx...
...........x.xx............x.x..............xx........x........x.x.....x......x.................xx..
..x...x..x..x.x......x.xx..x...........................x.......x.x......x.x..x...x.........xx.x.x...
xx.x..xx.x.x..xxx..x.x.xx...x.xxx......x...x.............................xx..x.x.xx..........x.xx...
xx.....x....x.......x........x...x..x..x...x.....x.....................xxxx..x...x...x...x..........
...x.x...xx...x............x...xxx.......xx.....x............................x..x.x..x...x..........
x...x.......x....x........xx.x.x..x.....x...x...x.................x.x..............x................
x..x.x......x.x..x.......xx....x........x...x..xx............xx...x.x..xxx...........x..............
xx...x..x.x......................xxx.xx........xx..........x.xx........xx...xx...x...x......x.......
.......xx..x.............x......x.....xx.........x...........x............x..xxx............x.......
................x.......x.x.x...................x......xx....xxx..x......xx.x.x......x.x......xx....
.........xx....x..................x..x..x...xx......x...x....x.x...x.....xxx.x.x.....x.x......xx....
........x...x.x..............xxx.x...x..x..x.................xxx.............x....x............x.xxx
......xx.x..x.xx.x.............................x.x....x.....................xx.......x........xxx..x
......x........x.x.........................x....x.x..x..xx.........x...x..x.....x....x......x..x.x.x
........x..x..........xx......x.x.............x..x..xx...x.xx......x...x......xx............x....x.x
...........xx........xxx......x.x.xx................x.x...................x.x....x................x.
................xx.............xx.x..x................x...................x.x.x.x.x.................
.........................x.....xx...................x..................xx.xx........................
..................xxx....x..xx....x............xxx.........x.......x..xx............................
...........................xxx...x.x..x..xx...xx.x.........x.......x...x...x......x...x.............
x......x.x.xxx....x.x.x.......xx............xxx............................xx.....x...x..xx.........
.x......x.........xx...x............x....x..xxx......x..x...x.......xx....x.x.......................
.....xx..x..xx.......x............xx....xx...x....xxx...x...x........x..xx..........................
..xx.....xxx...............x........xx.x.x...x.xx.xxxx...................x................xx....x...
.x..x...x.................x.x.......x..x.xxx....xxx.x.........x....xx........x.x.x.x.x.....x....x...
..xx.x..........................x...x...............x........xx..xx.x........x.x.x.x.x....x.........
.....x..x..........xxx.....x...x.x.xx........xx...............xxx..x.x.x............................
................xxx.x..x...x..x..x...........x..xxx.x...............................................
.................xx...xx..x.x.xxx.xx.x..x....x.....xxx.................................xx...........
........x.....x..x...x.x...xx...x.....x.xx...x.xx............xx.........................x.....xx....
...xx.xx.......x.x..xx.xx..xx............xxx..xx.................x.......................xxx..x.x..x
...xxx.xx........x..xx...........x.xx......xxx.x.................x.....................x....xx.x.xx.
.......xx.x..xx.......xx........x.x......x.x..xx.x...x.x...................................x........
.........x.x.x.....x.xx..............xx.xx.x..x...x..x.x............x......................x..x....x
............x....xx...........x.xx.x.xxx...x..................x.x....x..xxx...x....xxxx.........xx..
...............................x.x....x.........................x....x....x...x.......xxx.......x...
..........x....................x.............x.....x.........xx.......x..x.........x..........x.x...
............x..................x..x.x.x.x......x..xx.x.....x.........................x..x.......x...
............x.x.x.x.x..........x..xx..x....x....x.xx....xx............................xx...xxxx.....
.....x....x...xx....x.......x..x...........x.............x.xx.......................................
....x.x........xxx.......x................x..........xxx.x..x..............x........................
....x.............xx......................xx.xx...x........................x........................
...x.............x.x.....................xxx.x...xx.x........x.x..............x........x..x.........
....x...xx...........xx..................xx...x..x...........x.x............xxxx..x.x.....x......xx.
........x...x.......xx..............xx.....xx...........................x..xx...xx.x......x...x.....
........x...............xx.....x...xxx....xxxx.........................x....x......x.x....xxx.......
...........x.x..........xx.....x..xx....x...x...x.x........................x..xxx..x.......x..x.....
......xxx...x.x.....x.............xx......x..x..x.x................xx.........x.x............x......
........xx......x...xx................x.......................x......x.x............................
.x.x....xx....x.x..............x...x..x.x.....................x............xx.......................
.x.x..xx.............x.........x.............................x..xx.........x........................
......x...................xx....x...............x............x..xx.........x...........x..x.x...x.x.
.........................x..xx........xxx...xx.x..........x...xx..........x.x...x.x.x...x.x.x...x.x.
...................xx.x....x..xxx.....x.........xx......x..xx...................x.x.x...............
.............x.....xx.x......x.x......x.x...x....x....xx.x.x.........x.xx...........................
............x....................x...xx.x.x....x......xx..xx.....x...x..............................
............x.xx............x...x.....x..........x.....x..xx........................................
..x.x..xx..x.x...............x...x.......xx........x..x.xxx..........x...x..........................
.xx..x..x...x..........xxx......x........x.x.......x..x..xx......x..x...x.x.....x...xxx.............
.xx.......xx....x.x....x.x.................................x.....xxxx.xx........xxx...xx......x...x.
.......x...........x..................................................xx..........x....xx....x.x..x.
.....x..x........xx.x...............xx..........xx.........................x............x...x.......
..x...x..........xx...............x...........x...................................xx.........x..x.x.
............x.......xx.xx............x.x.x....xx..............x.x.....x......x....xxx.......x.x..x.x
.....x..x..x......................xx...x.x.....xx.....x.......x.x......xxx.x....x................x.x
..xx..x..x.............x..x.......................x............x...........x.x....................x.
x........x..........x.xxx..x...................xx.x...x......x...x.........x...x....................
x..x..xxx..xx........x....x..xx.x.....x.......x...........xx.x...x.xxx...x.x............x..x........
...xx.x.xx.....x.x.......x..x.x.x...x......xx.xx..................xx.x.xx..xx......x.x....x.........
.....x.........x.x..........xx........x....xx.......................x.x.....x..x....x.xx..x..x.x.x..
.......x...x................x....xx..................x..x...x.x.x...x..xx.x.x.x..x.x..x......x.x.x..
.x...........................x.........x.x............x.x...x.x.x.....x..x.......x..xxx.............
xx..x.....xx....x............x....x.....x....x...........................xx..x...xx...xx............
x...x.......xx..x.............x.x.x.xx.....x.xxx...........................xx..x....................
...x...xx..xxxx..............x...x.......x........x.............xx..................................
.......xxx..............x......x....x..x.....x.x.xx.....x.x.x......x......x......x..................
.....................xx..xx........xx..........x..x.....x.x.x......xx...x...........................
.................................xx..x.x............x.................x....x......xx................
......................x........xxx.....x.x.....x.x................x...........x....xx...............
....................x.......x.x...x.x..xx.....x...................x.........x..x.x..x...............
.........xxx.xxx....x...x......x..xx........x..........................x.x...x..xxx.................
x...x..x...x....................xx......x...x..x..........................x...........xxx...........
x...x..xx...x............x.x.........xx...............................xx............x...x.......x...
.........x.x........xxx...x......x.x..................................x...............x.x.......x...
............x......x.xx....x.....x.x................................xx...x......x..xx..x.xx.........
...........xx.....xx.x...x...........................................x...x.....x....x...............
...........xx.......xx........................................x................x.xxx.x..............
....x..........x.x...x.x...........xx.xxx.....................x...x..............xx.................
....x..x...x...x.x..x.....x.......xxxx.xx...x.....................x....x.........xx......xxx........
.....x...............x....x......xxxx.x.......x...............xx.....x..........x...xx.........x.x..
...x..x...x...........x.x.......x...x.x.......x.............x..x.....x.....xxx.....x.....xx....x.x..
...x........xxx...x..xx........x...xx.x..x..x...............x....xxx.xx.....x..............x.x......
.............x...xxxx.........xx.x....x..xx.......................x.x.xx....x.............xxx.......
.............xxx...............x....xxx...x...x................x......x..x..x........xxx.x.x........
.............x.x..............x.x...xx......x...x.x.......x..x...xx...x..x..x.....x....x......x.....
.....x..x......................x....x.x.x.x.....x.x.......x..x.....x.x....x...x..xx..x.x.x.xx.......
......x.x...........................x.x.x.x..........................x....x..xx....x.x..x.x.........
.....xx.xx....................xxx................xx..............x....x.......x...xx................
.......x........................................xx.............................xxx..................
